NO ./textures/wall.png
SO ./textures/wall2.png
WE ./textures/west.png
EA ./textures/east.png
F 220,100,0
C 225,30,0
1111111111111111111111111
1000000000110001111000001
1011000001110001001000111
1001000000000W0300100001111111111
111111111011000111110000000000001
100000000011000001110111100011111
11110111111111011100000010001
11110111111111011101010010001
10000000000000001100000010001
10000000000000001101010010001
11000001110101011111011110001
11110111 1110101 101111010001
11111111 1111111 111111111111