	NO ./textures/Wall.png
		 SO ./textures/Wall.png
 WE ./textures/Wall.png
 F 255,0,100
 C 255,0,50
 EA ./textures/Wall.png

1111111111111111111111111
1000000000110000000000001
1011000001110001111000111
100100000000W00000100001111111111
111111111011000111110000000000001
100000000011000001110111100011111
11110111111111011100000010001
11110111111111011101010010001
1000000000000000110000010001
10000000000000001101010010001
11000001110101011111011110001
11110111 1110101 101111010001
11111111 1111111 111111111111